NO ./xpm/creeper.xpm
SO ./xpm/ground.xpm
WE ./xpm/pig.xpm
EA ./xpm/sand.xpm

F     255,255,255
C 255,255,255

        11111111111111111111111111
        10000000001100000000000011
        11100000111000000000000W11
        11001000000000000000000001
111111111011000001110000000000001
100000000011000001110111111111111
11110111111111011100000010001
11110111111111011101010010001
11000000110101011100000010001
10000000000000001100000010001
10000000000000001101010010111
11000001110101011111011110011
11110111 1110101 101111010001
11111111 1111111 111111111111
1111111
1000001
111111
